15
15
***************
*             *
*             *
*             *
*             *
*             *
*             *
*             *
*             *
*             *
*******       *
*     *       *
*     *       *
*     *       *
***************
