15
15
***************
*             *
* *********** *
*           * *
*           *  
*           * *
*           * *
*           * *
*           * *
********** ****
*             *
*             *
*             *
*             *
***************
