15
15
***************
*     *       *
*** * *    *  *
*   * ******* *
*   *         *
* *********   *
*   *         *
*** *  ****   *
    *     *   *
***** *****   *
*        *    *
* ********** **
*        *    *
*    *        *
***************
